TTTTTTTTTTTTTTTTTTTTTTTTTTTTTTTTTTTTTTTTTTTTTTTTTT
TGGGGGGGGGGGGGGGGGGGGGGGGGGGGGGGGGGGGGGGGGGGGGGGGT
TGGGGGGGGGGGGGGGGGGGGGGGGGGGGGGGGGGGGGGGGGGGGGGGGT
TGGGGGGGGGGGGGGGGGGGGGGGGGGGGGGGGGGGGGGGGGGGGGGGGT
TGGGGGGGGGGGGGGGGGGGGGGGGGGGGGGGGBBBBBBBBBBGGGGGGT
TGGGGGGGGGGGGGGGGGGGGGGGGGGGGGGGGBDDDDDDDDBGGGGGGT
TGGGGGGGGGGGGGGGGGGGGGGGGGGGGGGGGBDDDDDDDDBGGGGGGT
TGGGGGGGGGGGGGGGGGGGGGGGGGGGGGGGGBDDDDDDDDBGGGGGGT
TGGGGGGGGGGGGGGGGGGGGGGGGGGGGGGGGBDDDDDDDDBGGGGGGT
TGGGGGGGGGGGGGGGGGGGGGGGGGGGGGGGGBDDDDDDDDBGGGGGGT
TGGGGGGGGGGGGGGGGGGGGGGGGGGGGGGGGBBBBBDBBBBGGGGGGT
TGGGGGGGGGGGGGGGGGGGGGGGGGGGGGGGGGGGGGGGGGGGGGGGGT
TGGGGGGGGGGGGGGGGGGGGGGGGGGGGGGGGGGGGGGGGGGGGGGGGT
TGGGGGGGGGGGGGGGGGGGGGGGGGGGGGGGGGGGGGGGGGGGGGGGGT
TGGGGGGGGGGGGGGGGGGGGGGGGGGGGGGGGGGGGGGGGGGGGGGGGT
TGGGGGGGGGGGGGGGGGGGGGGGGGGGGGGGGGGGGGGGGGGGGGGGGT
TGGGGGGGGGGGGGGGGGGGGGGGGGGGGGGGGGGGGGGGGGGGGGGGGT
TGGGGGGGGGGGGGGGGGGGGGGGGGGGGGGGGGGGGGGGGGGGGGGGGT
TGGGGGGGGGGGGGGGGGGGGGGGGGGGGGGGGGGGGGGGGGGGGGGGGT
TGTTTTTTTTTTTTTTTTTTTTGGGGGGGGGGGGGGGGGGGGGGGGGGGT
TGGSGBBBBBBBGBBBBBBBBTGGGGGGGGGGGGGGGGGGGGGGGGGGGT
TGTGGGGGBBGGGGGGGGGGGTGGGGGGGGGGGGGGGGGGGGGGGGGGGT
TGTBGGGGGBBBBGGGGGGGBTGGGGGGGGGGGGGGGGGGGGGGGGGGGT
TGTBGGGGGBBBBGGGGGGGBTGGGGGGGGGGGGGGGGGGGGGGGGGGGT
TGTBGGSSSSSSSGBBBBBBBTGGGGGGGGGGGGGGGGGGGGGGGGGGGT
TGTBGGSWWWWWSGGGGGGGGTGGGGGGGGGGGGGGGGGGGGGGGGGGGT
TGTBGGSWWWWWSGGGGGGGGTGGGGGGGGGGGGGGGGGGGGGGGGGGGT
TGTBGGSSSSSSSGGGGGGGGTGGGGGGGGGGGGGGGGGGGGGGGGGGGT
TTGTBBBBBBBBBBBBBBBBBEGGGGGGGGGGGGGGGGGGGGGGGGGGGT
TGTTTTTTTTTTTTTTTTTTTTGGGGGGGGGGGGGGGGGGGGGGGGGGGT
TGGGGGGGGGGGGGGGGGGGGGGGGGGGGGGGGGGGGGGGGGGGGGGGGT
TGGGGGGGGGGGGGGGGGGGGGGGGGGGGGGGGGGGGGGGGGGGGGGGGT
TGGGGGGGGGGGGGGGGGGGGGGGGGGGGGGGGGGGGGGGGGGGGGGGGT
TGGGGGGGGGGGGGGGGGGGGGGGGGGGGGGGGGGGGGGGGGGGGGGGGT
TGGGGGGGGGGGGGGGGGGGGGGGWWWWWWWWWWWWWWWWWWWWGGGGGT
TGGGGGGGGGGGGGGGGGGGGGGGSSSSSSSSSSSWWWWSSSSWGGGGGT
TGGGGGGGGGGGGGGGGGGGGGGGWWWSWWWWWWSWWWWSWWWWGGGGGT
TGGGGGGGGGGGGGGGGGGGGGGGWWWSWWWWWWSWWWWSWWWWGGGGGT
TGGGGGGGGGGGGGGGGGGGGGGGWWWSWWWWWWSSSSSSWWWWGGGGGT
TGGGGGGGGGGGGGGGGGGGGGGGWWWSWWWWWWWWWWWSWWWWGGGGGT
TGGGGGGGGGGGGGGGGGGGGGGGWWSSSSSSSSWWWWWSSSWWGGGGGT
TGGGGGGGGGGGGGGGGGGGGGGGWWSSWWWWWSSSSSSWWSWWGGGGGT
TGGGGGGGGGBBBBGGGGGGGGGGWWWSWWWWWSWWWWWWWSWWGGGGGT
TGGGGGGGGBWWWWBGGGGGGGGGWWWSWWWWWSSSSSSSWSWWGGGGGT
TGGGGGGGGBWWWWBGGGGGGGGGWWWSWWWWWWWWWWWWWWWWGGGGGT
TGGGGGGGGBBBBBBGGGGGGGGGGGGGGGGGGGGGGGGGGGGGGGGGGT
TGGGGGGGGGGGGGGGGGGGGGGGGGGGGGGGGGGGGGGGGGGGGGGGGT
TGGGGGGGGGGGGGGGGGGGGGGGGGGGGGGGGGGGGGGGGGGGGGGGGT
TGGGGGGGGGGGGGGGGGGGGGGGGGGGGGGGGGGGGGGGGGGGGGGGGT
TTTTTTTTTTTTTTTTTTTTTTTTTTTTTTTTTTTTTTTTTTTTTTTTTT