GGGGGGGGGGGGGGGG
GWWWWWWWWWWWGGGG
GWGGGGGGGGWWGGGG
GWGGGGGGGGWWGGLL
GWGGGGGGGGWWGGLL
GWWWWWWWWWWWGGLL
GGGGGGGGGGGGGGLL
LLLLLLLLLLLLLLLL
GGGGGGGGGGGGGGGG
GGGGGGGGGGGGGGGG
GGGGGGGGGGGGGGGG
GGGGGGGGGGGGGGGG
